..............
............
..........
.##..###...#...#...###...##...#.##...##...###.....
__________________________________________________
....
....
.@........#....##...#.#....###...#...##...#.......
__________________________________________________
...
.....
.#......##...##...#...###...#.#...##...###....#...
__________________________________________________
..............