..............
............
.##..###...#...#...###...##...#.##...##...###.....
__________________________________________________
....
.@..###...#....##...#.#....###...#...##...#.......
__________________________________________________
...
.#......##...##...#...###...#.#...##...###....#...
__________________________________________________
..............